
NO ./textures_2/diamond.xpm
         C  0,255           ,255
     SO ./textures_2/gold.xpm
WE     ./textures_2/brick.xpm
F 0   ,    255,      0


EA ./textures_2/metal.xpm

1111111111111111111111111    1
10000E0000110000000000001   101
1011000001110000000000001   101
10010000000000000000000011111011
111111111011000001110000000000001
10000000001100000111011111111011
111101111111110111000000100011
11110111111111011101010010001
10000000110101011100000010001
10000000000000001100000000001
10000000000000001101010010001
1100000111010101111101111000111
11110111 1110101 101111010001
11111111 1111111 111111111111