NO ./textures_2/red_brick.xpm
SO ./textures_2/wood.xpm
WE ./textures_2/blue_brick.xpm
EA ./textures_2/grey_brick.xpm

F 0, 255, 0
C 135, 206, 235

  1111111111111111111111111    1
111000000000110000000000001  1 101
10110000011100000000000011  101
100100000000000000000000111110111111
1111111110110000011100000000000000001
  100000000011000001110111111110111111
111101111111110111000000100011 1
11110111111111011101010010001
10000000110101011100000010001
10000000000000001100000000N01
10000000000000001101010010001
1100000111010101111101111000111
11110111 1110101 101111010001
11111111 1111111 111111111111